Orth	Phon
i	i
u	u
e	ɪ
o	ʊ
ê	ɛ
ô	ɔ
a	a
m	m
n	n
ny	ɲ
ng	ŋ
p	p
t	t
ts	ts
tl	tɬ
tš	tʃ
k	k
b	b
d	d
j	dʒ
ph	pʰ
th	tʰ
tsh	tsʰ
tlh	tɬʰ
tšh	tʃʰ
kh	kʰ
kg	kχʰ
f	f
s	s
š	ʃ
g	χ
h	h
r	r
l	l
w	w
y	j
