a	a
aa	aː
b	ɓ
bh	b̥ʱ
ch	ᵏǀʰ
c	ᵏǀʼ
d	d̥ʱ
dl	ɮ̈
dy	d̠̥ʲʱ
dz	d̥zʱ
ee	eː
e	ɛ
f	f
gc	ᶢ̥ǀʱ
g	ɡ̊ʱ
gq	ᶢ̥ǃʱ
gr	ɣ̈
gx	ᶢ̥ǁʱ
h	h
hh	ɦ
hl	ɬ
i	i
ii	iː
j	d̥ʒʱ
kh	kʰ
k	kʼ
kl	kʟ̥ʼ
krh	kxʰ
kr	kxʼ
lh	l̤
l	l
mh	m̤
m	m
nc	ᵑǀ
ngc	ᵑǀʱ
ngh	ŋ̈
ngq	ᵑǃʱ
ngx	ᵑǁʱ
ngʼ	ŋ
nh	n̤
nkc	ŋᵏǀʼ
nkq	ŋᵏǃʼ
nkx	ŋᵏǁʼ
n	n
nq	ᵑǃ
nx	ᵑǁ
nyh	n̠̈ʲ
ny	n̠ʲ
oo	oː
o	ɔ
ph	pʰ
p	pʼ
qh	ᵏǃʰ
q	ᵏǃʼ
rh	x
r	r
r	r̤
sh	ʃ
s	s
thsh	tʃʰ
ths	tsʰ
th	tʰ
tsh	tʃʼ
ts	tsʼ
t	tʼ
tyh	t̠ʲʰ
ty	t̠ʲʼ
u	u
uu	uː
v	v̤
wh	w̤
w	w
xh	ᵏǁʰ
x	ᵏǁʼ
yh	j̤
y	j
zh	ʒ̈
z	z̤
