Orth	Phon
a 	a 
b 	ɓ 
bh 	b 
c 	ǀ 
ch 	ǀʰ 
d 	d 
dl 	ɮ 
e 	e 
f 	f 
g 	ɡ 
gc 	ᶢǀʱ 
gq 	ᶢǃʱ 
gx 	ᶢǁʱ 
h 	h 
hh 	ɦ 
hl 	ɬ 
i 	i 
j 	dʒ 
k 	k 
k	ɠ 
kh 	kʰ 
kl 	kx 
l 	l 
m 	m 
m	mʱ 
mb 	mb 
n 	n 
n	nʱ 
nc 	ᵑǀ 
ng 	ŋ(ɡ) 
ngc 	ᵑǀʱ 
ngq 	ᵑǃʱ 
ngx 	ᵑǁʱ 
nj 	ɲdʒ 
nk 	ŋk 
nq 	ᵑǃ 
ntsh 	ɲtʃ 
nx 	ᵑǁ 
ny 	ɲ 
o 	o 
p 	p 
ph 	pʰ 
q 	ǃ 
qh 	ǃʰ 
r 	r 
s 	s 
sh 	ʃ 
t 	t 
th 	tʰ 
ts 	ts 
tsh 	tʃ 
u 	u 
v 	v 
w 	w 
w	wʱ 
x 	ǁ 
xh 	ǁʰ 
y 	j 
y	jʱ 
z 	z 
