Orth	Phon
i	i
u	u
e	e
e	ɛ
o	o
o	ɔ
a	a
p	pʼ
k	kʼ
ph	pʰ
h	tʰ
kh	kʰ
bh	b̥
d	d̥
ɡ	ɡ̊
mp	ᵐp
nk	ᵑk
mb	ᵐb
nd	ⁿd
ng	ᵑɡ
b	ɓ
s	tsʼ
l	tɬʼ
j	tʃʼ
kg	kxʼ
sh	tsʰ
lh	tɬʰ
jh	tʃʰ
kgh	kxʰ
dz	dz
j	d̥ʒ
nj	ᶮdʒ
f	f
s	s
hl	ɬ
rh	x
v	v
z	z
dl	ɮ
h	ɦ
mf	ᶬf
mv	ᶬv
dlh	ɮʰ
m	m
n	n
ny	ɲ
ngh	ŋ
r	r
l	l
w	w
y	j
c	ᵏǀ
q	ᵏ!
x	ᵏǁ
ch	ᵏǀʰ
qh	ᵏ!ʰ
gc	ᶢǀ
gq	ᶢ!
nc	ᵑǀ
nq	ᵑ!
nx	ᵑǁ
