Orth	Phon
a 	ɑ
b 	b
bj 	bʒ
d 	d
e 	ɨ
e	e
e	ɛ
f 	f
fj 	fʃ
h 	h
hl 	ɬ
i 	i
j 	ʒ
j	d͡ʒ
k 	kʼ
kh 	kʰ
kg 	x
kg	k͡xʰ
l 	l
m 	m
n 	n
ng 	ŋ
nq 	ᵑǃ
ny 	ɲ
o 	ʉ
o	o
o	ɔ
p 	pʼ
ph 	pʰ
pj 	pʃʼ
pjh 	pʃʰ
q 	ǃ
qh 	ǃʰ
r 	ʁ
s 	s
sh 	ʃ
t 	tʼ
th 	tʰ
tj 	t͡ʃʼ
tjh 	t͡ʃʰ
tl 	tɬʼ
tlh 	t͡ɬʰ
ts 	tsʼ
tsh 	tsʰ
u 	u
w 	w
y 	j
